{
    "map": {
        "zone": "tuto",
        "id": "0-2-2",
        "events": "1",
        "tileset": "inside"
    },
    "layers": [
        [
            [0, 0, 0, 113, 113, 113, 113, 0, 0, 0],
            [0, 0, 0, 99, 99, 99, 99, 0, 0, 0],
            [0, 0, 0, 113, 113, 113, 113, 0, 0, 0],
            [0, 99, 99, 99, 99, 99, 99, 99, 99, 0],
            [0, 113, 113, 113, 113, 113, 113, 113, 113, 0],
            [0, 99, 99, 99, 99, 99, 99, 99, 99, 0],
            [0, 113, 113, 113, 113, 113, 113, 113, 113, 0],
            [0, 99, 99, 99, 99, 99, 99, 99, 99, 0],
            [0, 113, 113, 113, 113, 113, 113, 113, 113, 0],
            [0, 99, 99, 99, 99, 99, 99, 99, 99, 0],
            [0, 113, 113, 113, 113, 113, 113, 113, 113, 0],
            [0, 99, 99, 99, 99, 99, 99, 99, 99, 0],
            [0, 113, 113, 113, 113, 113, 113, 99, 113, 0],
            [0, 0, 0, 0, 99, 99, 99, 113, 0, 0]
        ],
        [
            [0, 0, 0, 123, 0, 0, 124, 0, 0, 0],
            [0, 52, 53, 0, 0, 0, 0, 52, 53, 0],
            [0, 66, 67, 16, 0, 0, 19, 66, 67, 0],
            [0, 0, 0, 0, 0, 0, 0, 0, 0, 0],
            [0, 0, 0, 0, 0, 0, 0, 0, 0, 0],
            [0, 0, 0, 0, 0, 0, 0, 0, 0, 0],
            [0, 0, 0, 0, 0, 0, 0, 0, 0, 0],
            [0, 0, 0, 0, 0, 0, 0, 0, 0, 0],
            [0, 0, 0, 0, 0, 0, 0, 0, 0, 0],
            [0, 0, 0, 0, 0, 0, 0, 0, 0, 0],
            [0, 239, 0, 0, 0, 0, 0, 0, 241, 0],
            [0, 0, 0, 0, 0, 0, 0, 0, 0, 0],
            [0, 0, 0, 0, 123, 0, 0, 124, 0, 0],
            [0, 0, 0, 0, 123, 0, 0, 124, 0, 0]
        ],
        [
            [0, 0, 0, 0, 0, 0, 0, 0, 0, 0],
            [0, 212, 0, 0, 0, 0, 0, 0, 212, 0],
            [0, 226, 0, 197, 0, 0, 198, 0, 226, 0],
            [0, 240, 0, 0, 0, 0, 0, 0, 240, 0],
            [0, 0, 0, 0, 0, 0, 0, 0, 0, 0],
            [0, 0, 0, 0, 0, 0, 0, 0, 0, 0],
            [0, 0, 0, 0, 0, 0, 0, 0, 0, 0],
            [0, 0, 0, 0, 0, 0, 0, 0, 0, 0],
            [0, 0, 0, 0, 0, 0, 0, 0, 0, 0],
            [0, 0, 0, 0, 0, 0, 0, 0, 0, 0],
            [0, 0, 0, 0, 0, 0, 0, 0, 0, 0],
            [0, 0, 0, 0, 0, 0, 0, 0, 0, 0],
            [0, 0, 0, 0, 0, 0, 0, 0, 0, 0],
            [0, 0, 0, 0, 0, 0, 0, 0, 0, 0]
        ],
        [
            [0, 0, 0, 0, 0, 0, 0, 0, 0, 0],
            [0, 0, 0, 0, 0, 0, 0, 0, 0, 0],
            [0, 0, 0, 0, 0, 0, 0, 0, 0, 0],
            [0, 0, 0, 0, 0, 0, 0, 0, 0, 0],
            [0, 0, 0, 0, 0, 0, 0, 0, 0, 0],
            [0, 0, 0, 0, 0, 0, 0, 0, 0, 0],
            [0, 155, 0, 0, 0, 0, 0, 0, 155, 0],
            [0, 0, 0, 0, 0, 0, 0, 0, 0, 0],
            [0, 0, 0, 0, 0, 0, 0, 0, 0, 0],
            [0, 0, 0, 0, 0, 0, 0, 0, 0, 0],
            [0, 0, 0, 0, 0, 0, 0, 0, 0, 0],
            [0, 0, 0, 0, 0, 0, 0, 0, 0, 0],
            [0, 0, 0, 0, 0, 0, 0, 0, 0, 0],
            [0, 0, 0, 0, 0, 0, 0, 0, 0, 0]
        ],
        [
            [0, 0, 0, 0, 0, 0, 0, 0, 0, 0],
            [0, 0, 0, 2, 7, 8, 5, 0, 0, 0],
            [0, 0, 0, 0, 0, 0, 0, 0, 0, 0],
            [0, 0, 0, 0, 0, 0, 0, 0, 0, 0],
            [0, 199, 0, 0, 0, 0, 0, 0, 200, 0],
            [0, 141, 0, 0, 0, 0, 0, 0, 141, 0],
            [0, 0, 0, 0, 0, 0, 0, 0, 0, 0],
            [0, 0, 0, 0, 0, 0, 0, 0, 0, 0],
            [0, 211, 0, 0, 0, 0, 0, 0, 213, 0],
            [0, 225, 0, 0, 0, 0, 0, 0, 227, 0],
            [0, 0, 0, 0, 0, 0, 0, 0, 0, 0],
            [0, 54, 54, 54, 123, 0, 0, 124, 54, 0],
            [0, 68, 68, 68, 0, 0, 0, 0, 68, 0],
            [0, 0, 0, 0, 0, 0, 0, 0, 0, 0]
        ],
        [
            [0, 0, 0, 0, 0, 0, 0, 0, 0, 0],
            [29, 0, 0, 0, 0, 0, 0, 0, 0, 42],
            [29, 0, 0, 0, 0, 0, 0, 0, 0, 42],
            [29, 0, 0, 0, 0, 0, 0, 0, 0, 42],
            [29, 0, 0, 0, 0, 0, 0, 0, 0, 42],
            [29, 0, 0, 0, 0, 0, 0, 0, 0, 42],
            [29, 0, 0, 0, 0, 0, 0, 0, 0, 42],
            [29, 0, 0, 0, 0, 0, 0, 0, 0, 42],
            [29, 0, 0, 0, 0, 0, 0, 0, 0, 42],
            [29, 0, 0, 0, 0, 0, 0, 0, 0, 42],
            [29, 0, 0, 0, 0, 0, 0, 0, 0, 42],
            [43, 0, 0, 0, 0, 0, 0, 0, 0, 56],
            [57, 0, 0, 0, 0, 0, 0, 0, 0, 70],
            [0, 0, 0, 0, 0, 0, 0, 0, 0, 0]
        ],
        [
            [0, 0, 0, 0, 0, 0, 0, 0, 0, 0],
            [0, 0, 0, 0, 0, 0, 0, 0, 0, 0],
            [0, 0, 0, 0, 0, 0, 0, 0, 0, 0],
            [0, 0, 0, 0, 0, 0, 0, 0, 0, 0],
            [0, 0, 0, 0, 0, 0, 0, 0, 0, 0],
            [0, 0, 0, 0, 0, 0, 0, 0, 0, 0],
            [0, 0, 0, 0, 0, 0, 0, 0, 0, 0],
            [0, 0, 0, 0, 0, 0, 0, 0, 0, 0],
            [0, 0, 0, 0, 0, 0, 0, 0, 0, 0],
            [0, 0, 0, 0, 0, 0, 0, 0, 0, 0],
            [0, 0, 0, 0, 0, 0, 0, 0, 0, 0],
            [0, 0, 0, 0, 0, 0, 0, 0, 0, 0],
            [0, 0, 0, 0, 0, 0, 0, 0, 0, 0],
            [0, 0, 0, 0, 0, 0, 0, 0, 0, 0]
        ],
        [
            [0, 0, 0, 0, 0, 0, 0, 0, 0, 0],
            [0, 0, 0, 0, 0, 0, 0, 0, 0, 0],
            [0, 0, 0, 0, 0, 0, 0, 0, 0, 0],
            [0, 0, 0, 0, 0, 0, 0, 0, 0, 0],
            [0, 0, 0, 0, 0, 0, 0, 0, 0, 0],
            [0, 0, 0, 0, 0, 0, 0, 0, 0, 0],
            [0, 0, 0, 0, 0, 0, 0, 0, 0, 0],
            [0, 0, 0, 0, 0, 0, 0, 0, 0, 0],
            [0, 0, 0, 0, 0, 0, 0, 0, 0, 0],
            [0, 0, 0, 0, 0, 0, 0, 0, 0, 0],
            [0, 0, 0, 0, 0, 0, 0, 0, 0, 0],
            [0, 0, 0, 0, 0, 0, 0, 0, 0, 0],
            [0, 0, 0, 0, 0, 0, 0, 0, 0, 0],
            [0, 0, 0, 0, 0, 0, 0, 0, 0, 0]
        ]
    ],
    "collision": [
        [
            [1, 1, 1, 1, 1, 1, 1, 0, 0, 0, 0, 0, 0, 1, 1, 1, 1, 1, 1, 1],
            [1, 1, 1, 1, 1, 1, 1, 0, 0, 0, 0, 0, 0, 1, 1, 1, 1, 1, 1, 1],
            [1, 1, 1, 1, 1, 1, 1, 0, 0, 0, 0, 0, 0, 1, 1, 1, 1, 1, 1, 1],
            [1, 1, 1, 1, 1, 1, 1, 0, 0, 0, 0, 0, 0, 1, 1, 1, 1, 1, 1, 1],
            [1, 1, 1, 1, 1, 1, 1, 1, 0, 0, 0, 0, 1, 1, 1, 1, 1, 1, 1, 1],
            [1, 1, 1, 1, 1, 1, 1, 1, 0, 0, 0, 0, 1, 1, 1, 1, 1, 1, 1, 1],
            [1, 1, 1, 1, 0, 0, 0, 0, 0, 0, 0, 0, 0, 0, 0, 0, 1, 1, 1, 1],
            [1, 1, 0, 0, 0, 0, 0, 0, 0, 0, 0, 0, 0, 0, 0, 0, 0, 0, 1, 1],
            [1, 1, 0, 0, 0, 0, 0, 0, 0, 0, 0, 0, 0, 0, 0, 0, 0, 0, 1, 1],
            [1, 1, 0, 0, 0, 0, 0, 0, 0, 0, 0, 0, 0, 0, 0, 0, 0, 0, 1, 1],
            [1, 1, 0, 0, 0, 0, 0, 0, 0, 0, 0, 0, 0, 0, 0, 0, 0, 0, 1, 1],
            [1, 1, 0, 0, 0, 0, 0, 0, 0, 0, 0, 0, 0, 0, 0, 0, 0, 0, 1, 1],
            [1, 1, 1, 1, 0, 0, 0, 0, 0, 0, 0, 0, 0, 0, 0, 0, 1, 1, 1, 1],
            [1, 1, 1, 1, 0, 0, 0, 0, 0, 0, 0, 0, 0, 0, 0, 0, 1, 1, 1, 1],
            [1, 1, 0, 0, 0, 0, 0, 0, 0, 0, 0, 0, 0, 0, 0, 0, 0, 0, 1, 1],
            [1, 1, 0, 0, 0, 0, 0, 0, 0, 0, 0, 0, 0, 0, 0, 0, 0, 0, 1, 1],
            [1, 1, 0, 0, 0, 0, 0, 0, 0, 0, 0, 0, 0, 0, 0, 0, 0, 0, 1, 1],
            [1, 1, 0, 0, 0, 0, 0, 0, 0, 0, 0, 0, 0, 0, 0, 0, 0, 0, 1, 1],
            [1, 1, 0, 0, 0, 0, 0, 0, 0, 0, 0, 0, 0, 0, 0, 0, 0, 0, 1, 1],
            [1, 1, 0, 0, 0, 0, 0, 0, 0, 0, 0, 0, 0, 0, 0, 0, 0, 0, 1, 1],
            [1, 1, 1, 0, 0, 0, 0, 0, 0, 0, 0, 0, 0, 0, 0, 0, 0, 1, 1, 1],
            [1, 1, 1, 0, 0, 0, 0, 0, 0, 0, 0, 0, 0, 0, 0, 0, 0, 1, 1, 1],
            [1, 1, 0, 0, 0, 0, 0, 0, 0, 0, 0, 0, 0, 0, 0, 0, 0, 0, 1, 1],
            [1, 1, 0, 0, 0, 0, 0, 0, 0, 0, 0, 0, 0, 0, 0, 0, 0, 0, 1, 1],
            [1, 1, 1, 1, 1, 1, 1, 1, 1, 0, 0, 0, 0, 0, 0, 1, 1, 1, 1, 1],
            [1, 1, 1, 1, 1, 1, 1, 1, 1, 0, 0, 0, 0, 0, 0, 1, 1, 1, 1, 1],
            [1, 1, 1, 1, 1, 1, 1, 1, 1, 0, 0, 0, 0, 0, 0, 1, 1, 1, 1, 1],
            [1, 1, 1, 1, 1, 1, 1, 1, 1, 0, 0, 0, 0, 0, 0, 1, 1, 1, 1, 1]
        ]
    ],
    "entries": {
        "default": 0,
        "1": [
            [5.0, 10.5],
            "down"
        ],
        "0": [
            [6.0, 2.0],
            "up"
        ]
    },
    "entities": [
        [
            ["PressurePlate", [[1.5, 6.5], 0]],
            ["PressurePlate", [[8.5, 6.5], 0]],
            ["TogglePlate", [[1.5, 8.5], 0]],
            ["TogglePlate", [[8.5, 8.5], 0]],
            ["SlidingBlock", [[4.5, 5.5]]],
            ["SlidingBlock", [[4.5, 4.5]]],
            ["SpawnPoint", [[5.0, 11.5]]],
            ["Tp", [[5.0, 13.0], [3.0, 2.0], "tuto", "0-2-3", 0, 0]],
            ["InteractionSwitch", [[5.0, 11.5], [2.0, 1.0], 0, 1, 0]],
            ["Decor", [[3.5, 11.5], 0, "door-up-down", "door-up-open-down"]],
            ["Decor", [[3.5, 12.5], 0, "door-up-up", "door-up-open-up"]],
            ["Tp", [[6.0, 0.75], [3.0, 1.5], "tuto", "0-2-1", 1, -1]],
            ["SpawnPoint", [[6.0, 3.0]]]
        ]
    ]
}