{
    "map": {
        "zone": "tuto",
        "id": "0-2-0",
        "events": "0"
    },
    "layers": [
        [
            [0, 0, 0, 0, 1, 1, 1, 1, 1, 1],
            [0, 0, 0, 0, 1, 1, 1, 1, 1, 1],
            [0, 0, 0, 0, 1, 1, 1, 1, 1, 1],
            [0, 0, 0, 0, 1, 1, 1, 1, 1, 1],
            [0, 0, 0, 0, 1, 1, 1, 1, 1, 1],
            [0, 0, 0, 0, 0, 1, 1, 1, 1, 1],
            [0, 0, 0, 0, 0, 1, 1, 1, 1, 1],
            [1, 1, 2, 2, 1, 1, 1, 1, 1, 1],
            [1, 1, 1, 1, 1, 1, 1, 1, 1, 1],
            [1, 1, 1, 1, 1, 1, 1, 1, 1, 1],
            [0, 0, 0, 0, 0, 1, 1, 1, 1, 1],
            [0, 0, 0, 0, 0, 1, 1, 1, 1, 1],
            [0, 0, 0, 0, 1, 1, 1, 1, 1, 1],
            [0, 0, 0, 0, 1, 1, 1, 1, 1, 1],
            [0, 0, 0, 0, 1, 1, 1, 1, 1, 1],
            [0, 0, 0, 0, 1, 1, 1, 1, 1, 1],
            [0, 0, 0, 0, 1, 1, 1, 1, 1, 1],
            [0, 0, 0, 0, 1, 2, 2, 1, 1, 1]
        ],
        [
            [0, 0, 0, 0, 3, 3, 3, 3, 3, 3],
            [0, 0, 0, 0, 3, 0, 0, 0, 0, 3],
            [0, 0, 0, 0, 3, 0, 0, 0, 0, 3],
            [0, 0, 0, 0, 3, 0, 0, 0, 0, 3],
            [0, 0, 0, 0, 3, 3, 3, 0, 3, 3],
            [0, 0, 0, 0, 0, 3, 0, 0, 0, 3],
            [0, 0, 0, 0, 0, 3, 0, 0, 0, 3],
            [3, 3, 0, 0, 3, 3, 3, 0, 0, 3],
            [3, 0, 0, 0, 0, 0, 0, 0, 0, 3],
            [3, 3, 3, 3, 3, 3, 3, 0, 0, 3],
            [0, 0, 0, 0, 0, 3, 0, 0, 0, 3],
            [0, 0, 0, 0, 0, 3, 0, 0, 0, 3],
            [0, 0, 0, 0, 3, 3, 3, 0, 3, 3],
            [0, 0, 0, 0, 3, 0, 0, 0, 0, 3],
            [0, 0, 0, 0, 3, 0, 0, 0, 0, 3],
            [0, 0, 0, 0, 3, 0, 0, 0, 0, 3],
            [0, 0, 0, 0, 3, 0, 0, 0, 0, 3],
            [0, 0, 0, 0, 3, 0, 0, 3, 3, 3]
        ]
    ],
    "collision": [
        [
            [0, 0, 0, 0, 0, 0, 0, 0, 1, 1, 1, 1, 1, 1, 1, 1, 1, 1, 1, 1],
            [0, 0, 0, 0, 0, 0, 0, 0, 1, 1, 1, 1, 1, 1, 1, 1, 1, 1, 1, 1],
            [0, 0, 0, 0, 0, 0, 0, 0, 1, 1, 0, 0, 0, 0, 0, 0, 0, 0, 1, 1],
            [0, 0, 0, 0, 0, 0, 0, 0, 1, 1, 0, 0, 0, 0, 0, 0, 0, 0, 1, 1],
            [0, 0, 0, 0, 0, 0, 0, 0, 1, 1, 0, 0, 0, 0, 0, 0, 0, 0, 1, 1],
            [0, 0, 0, 0, 0, 0, 0, 0, 1, 1, 0, 0, 0, 0, 0, 0, 0, 0, 1, 1],
            [0, 0, 0, 0, 0, 0, 0, 0, 1, 1, 0, 0, 0, 0, 0, 0, 0, 0, 1, 1],
            [0, 0, 0, 0, 0, 0, 0, 0, 1, 1, 0, 0, 0, 0, 0, 0, 0, 0, 1, 1],
            [0, 0, 0, 0, 0, 0, 0, 0, 1, 1, 1, 1, 1, 1, 0, 0, 1, 1, 1, 1],
            [0, 0, 0, 0, 0, 0, 0, 0, 1, 1, 1, 1, 1, 1, 0, 0, 1, 1, 1, 1],
            [0, 0, 0, 0, 0, 0, 0, 0, 0, 0, 1, 1, 0, 0, 0, 0, 0, 0, 1, 1],
            [0, 0, 0, 0, 0, 0, 0, 0, 0, 0, 1, 1, 0, 0, 0, 0, 0, 0, 1, 1],
            [0, 0, 0, 0, 0, 0, 0, 0, 0, 0, 1, 1, 0, 0, 0, 0, 0, 0, 1, 1],
            [0, 0, 0, 0, 0, 0, 0, 0, 0, 0, 1, 1, 0, 0, 0, 0, 0, 0, 1, 1],
            [1, 1, 1, 1, 0, 0, 0, 0, 1, 1, 1, 1, 1, 1, 0, 0, 0, 0, 1, 1],
            [1, 1, 1, 1, 0, 0, 0, 0, 1, 1, 1, 1, 1, 1, 0, 0, 0, 0, 1, 1],
            [1, 1, 0, 0, 0, 0, 0, 0, 0, 0, 0, 0, 0, 0, 0, 0, 0, 0, 1, 1],
            [1, 1, 0, 0, 0, 0, 0, 0, 0, 0, 0, 0, 0, 0, 0, 0, 0, 0, 1, 1],
            [1, 1, 1, 1, 1, 1, 1, 1, 1, 1, 1, 1, 1, 1, 0, 0, 0, 0, 1, 1],
            [1, 1, 1, 1, 1, 1, 1, 1, 1, 1, 1, 1, 1, 1, 0, 0, 0, 0, 1, 1],
            [0, 0, 0, 0, 0, 0, 0, 0, 0, 0, 1, 1, 0, 0, 0, 0, 0, 0, 1, 1],
            [0, 0, 0, 0, 0, 0, 0, 0, 0, 0, 1, 1, 0, 0, 0, 0, 0, 0, 1, 1],
            [0, 0, 0, 0, 0, 0, 0, 0, 0, 0, 1, 1, 0, 0, 0, 0, 0, 0, 1, 1],
            [0, 0, 0, 0, 0, 0, 0, 0, 0, 0, 1, 1, 0, 0, 0, 0, 0, 0, 1, 1],
            [0, 0, 0, 0, 0, 0, 0, 0, 1, 1, 1, 1, 1, 1, 0, 0, 1, 1, 1, 1],
            [0, 0, 0, 0, 0, 0, 0, 0, 1, 1, 1, 1, 1, 1, 0, 0, 1, 1, 1, 1],
            [0, 0, 0, 0, 0, 0, 0, 0, 1, 1, 0, 0, 0, 0, 0, 0, 0, 0, 1, 1],
            [0, 0, 0, 0, 0, 0, 0, 0, 1, 1, 0, 0, 0, 0, 0, 0, 0, 0, 1, 1],
            [0, 0, 0, 0, 0, 0, 0, 0, 1, 1, 0, 0, 0, 0, 0, 0, 0, 0, 1, 1],
            [0, 0, 0, 0, 0, 0, 0, 0, 1, 1, 0, 0, 0, 0, 0, 0, 0, 0, 1, 1],
            [0, 0, 0, 0, 0, 0, 0, 0, 1, 1, 0, 0, 0, 0, 0, 0, 0, 0, 1, 1],
            [0, 0, 0, 0, 0, 0, 0, 0, 1, 1, 0, 0, 0, 0, 0, 0, 0, 0, 1, 1],
            [0, 0, 0, 0, 0, 0, 0, 0, 1, 1, 0, 0, 0, 0, 0, 0, 0, 0, 1, 1],
            [0, 0, 0, 0, 0, 0, 0, 0, 1, 1, 0, 0, 0, 0, 0, 0, 0, 0, 1, 1],
            [0, 0, 0, 0, 0, 0, 0, 0, 1, 1, 0, 0, 0, 0, 1, 1, 1, 1, 1, 1],
            [0, 0, 0, 0, 0, 0, 0, 0, 1, 1, 0, 0, 0, 0, 1, 1, 1, 1, 1, 1]
        ]
    ],
    "entries": {
        "default": 0,
        "0": [
            3.0,
            9.5
        ],
        "1": [
            6.0,
            1.5
        ]
    },
    "entities": [
        [
            ["SlidingBlock", [[7.5, 5.5]]],
            ["SlidingBlock", [[7.5, 8.5]]],
            ["SlidingBlock", [[6.5, 9.5]]],
            ["SlidingBlock", [[7.5, 10.5]]],
            ["SlidingBlock", [[7.5, 13.5]]],
            ["SlidingBlock", [[6.5, 15.5]]],
            ["Door", [[3.0, 10.5], [1.998, 0.498], "tuto", "0-1-1", 1, false]],
            ["Door", [[6.0, 0.5], [1.998, 0.498], "tuto", "0-2-1", 0, false]],
            ["SpawnPoint", [[3.0, 10.5]]],
            ["SpawnPoint", [[6.0, 2.5]]]
        ]
    ]
}